###################
#zooooooo#oooooooz#
#o##o###o#o###o##o#
#o@ooooooooooooooo#
#o##o#o#####o#o##o#
#oooo#ooo#ooo#oooo#
####o###o#o###o####
xxx#o#ooo1ooo#o#xxx
####o#o##1##o#o####
ooooooo#111#ooooooo
####o#o#####o#o####
xxx#o#ooooooo#o#xxx
####o#o#####o#o####
#oooooooo#oooooooo#
#o##o###o#o###o##o#
#oo#ooooooooooo#oo#
##o#o#o#####o#o#o##
#oooo#ooo#ooo#oooo#
#o######o#o######o#
#zoooooooooooooooz#
###################
